#############
#     #     #
#  #     #  #
#  #######  #
#  #     #  #
#  #  #  #  #
#  #  #  #  #
#  #  #  #  #
#     #     #
#############