####################################    ########################################
#       #       #       #                  #           #       #           #   #
#       #       #       #                  #           #       #           #   #
#       #       #       #                  #           #       #           #   #
#   #####   #   #   #   #   #   ####       #       #   #   #####   #####   #   #
#           #   #   #       #   #          #   #   #   #   #       #   #   #   #
#           #   #   #       #   #          #   #   #   #   #       #   #   #   #
#           #   #   #       #   #          #   #   #   #   #       #   #   #   #
#############   #   #   #########   ####   #   #   #####   #    ####   #   #   #
#   #       #       #           #          #   #                   #       #   #
#   #       #       #           #          #   #                   #       #   #
#   #       #       #           #          #   #                   #       #   #
#       #   #########   #####   ############   #################   #########   #
#       #   #           #   #       #          #               #           #   #
#       #   #           #   #       #          #               #           #   #
#       #   #           #   #       #          #               #           #   #
#####   #   #############       #   ####       #############   #####   #       #
#       #       #       #       #          #           #       #   #   #       #
#       #       #       #       #          #           #       #   #   #       #
#       #       #       #       #          #           #       #   #   #       #
#   #########       #   #########   ############   #       #####       #########
#           #       #       #       #          #   #       #   #       #       #
#           #       #       #       #          #   #       #   #       #       #
#           #       #       #       #          #   #       #   #       #       #
#####################   #####   #####   ####    ########   #        ########   #
#       #       #           #       #      #           #   #                   #
#       #       #           #       #      #           #   #                   #
#       #       #           #       #      #           #   #                   #
#   #       #       #   #   ####    ####   #########   #########################
#   #       #       #   #           #      #           #                       #
#   #       #       #   #           #      #           #                       #
#   #       #       #   #          ##      #           #                       #
#   #################   ############   #####   #########    ###############    #
#   #       #       #       #   #              #               #       #       #
#   #       #       #       #   #              #               #       #       #
#   #       #       #       #   #      #       #               #       #       #
#   #    ###    #########       #   #####  #####   #############   #####   #####
#   #           #       #       #          #       #               #       #   #
#   #           #       #       #          #       #               #       #   #
#   #           #   #   #       #          #       ##      #       #       #   #
#   #               #   #       #  ##      #       #       #       #   #       #
#   #               #               #      #               #       #   #       #
#   #               #               #      #               #       #   #       #
#   #    #######    #       ####    #####  #    ########   #    ####   #    ####
#   #       #       #   #      ##   #      #   ##  #       #       #           #
#   #       #       #   #       #   #      #   #   #       #       #           #
#   #       #       #   #       #   #      #   #   #       #       #           #
#   ####    #   #####   #########   #      #   #   #    ########   ########    #
#           #       #   #       #   #      #       #           #       #       #
#           #       #   #       #   #      #       #           #       #       #
#           #       #   #       #   #      #       #           #       #       #
#####################   #       #   #####  #####   #########   #####   #       #
#                   #       #   #              #   #           #       #   #   #
#                   #       #   #              #   #           #       #   #   #
#                   #       #   #              #   #           #       #   #   #
#   #####   ####    #########   ################   #   #########       #   #   #
#       #   #       #       #   #                  #   #           #   #   #   #
#       #   #       #       #   #                  #   #           #   #   #   #
#       #   #       #       #   #                  #   #           #   #   #   #
#########   #   #####       #   #           ########   #   #############   #   #
#           #   #       #           #              #   #   #           #   #   #
#           #   #       #           #              #   #   #           #   #   #
#           #   #       #           #              #   #   #           #   #   #
#   #############       #########   #####      #####   #   #   #####   #   #   #
#   #               #           #   #      #   #       #       #   #       #   #
#   #               #           #   #      #   #       #       #   #       #   #
#   #               #           #   #      #   #       #       #   #       #   #
#   #   #####################   #####   ########   #########   #   #########   #
#   #   #       #           #       #      #       #   #       #   #   #       #
#   #   #       #           #       #      #       #   #       #   #   #       #
#   #   #       #           #       #      #       #   #       #   #   #       #
#   #   #   #   #   ####    #####   #      #    ####   #   #####   #   #   #####
#   #       #       #       #   #   #      #       #       #       #   #       #
#   #       #       #       #   #   #      #       #       #       #   #       #
#   #       #       #       #   #   #      #       #       #       #   #       #
#   #################   #   #   #       ########   #    ####   #####   #####   #
#                       #       #                  #           #               #
#                       #       #                  #           #               #
#                       #       #                  #           #               #
########################################    ####################################
