####################
#            # #   #
# #  #  #  # # # # #
#            #   ###
#       #  # # # # #
### ########## #   #
  # #              #
### ############ # #
#      #     #   # #
#  #   #     # #   #
#  #         # ### #
#  #               #
####################