#########
#   #   #
# #   # #
# ##### #
# #   # #
# # # # #
# # # # #
# # # # #
#   #   #
#########